1111111111111111111111111111111111
10000000000000EC00000C0000000001C1
1010010100100000101001000000010111
1010010010101010001001000000010101
100000000C00C000000000P000000000C1
1111111111111111111111111111111111