11111
1CP01
10001
10001
10001
10001
10001
10E11
10101
11111