1111111111111111111111111111111111
100000E00000000C00000C00000P000101
1010010100100001101001000000010111
1010010010101011001001000000010111
100000000C00C0010000000000000000C1
1111111111111111111111111111111111
