1111111111111111111111111111111111
10000E000000000C00000C00000P000101
1010010100100000101001000000010111
1010010010101010001001000000010111
100000000C00C0000000000000000000C1
1111111111111111111111111111111111